R  1000 1000
NO            ./textures/red.xpm
SO ./textures/bluestone.xpm
EA ./textures/greystone.xpm
WE ./textures/red.xpm

S ./textures/tonneau.xpm
F 200,             255,255
C 238  ,175,97

11111111111111111
10011100000101111
10001100000001111
10000000000000111
10000000000000001
11110000000N00001
11110000000000001
10000000000110001
11111111111111111
